WWWWWWWWWWWWDWWWWWWWWWWWW
WE.........WLW.........EW
W.W.W.WWWW.WLW.WWWW.W.W.W
W.WHW.W....LPL....W.WCW.W
W.WWW.W.WWWWWWWWW.W.WWW.W
W.....W.WK..W..OW.W.....W
W.WWWWW.W.W.W.W.W.WWWWW.W
W......EW...W...WE......W
W.WWWWW.WWW.W.WWW.WWWWW.W
W.W...W...W.W.W...W...W.W
W...WSWWW.W.W.W.WWWYW...W
W.W...W...W.W.W...W...W.W
W.WWWWW.WWW.W.WWW.WWWWW.W
WE..........W..........EW
WWWWWWWWWWWWWWWWWWWWWWWWW