WWWWWWWWWWWWDWWWWWWWWWWWW
WE.....................EW
W.WWWWWWW.WWWWW.WWWWWWW.W
W.W.....W.LLWLL.W.....W.W
W...WWWCW.WLPLW.WHWWW...W
W.W.....W.WWLWW.W.....W.W
W.WWWWWWW.WLLLW.WWWWWWW.W
W...........W...........W
W.WW.WWWWWWWWWWWWWWW.WW.W
WS.W...L.L..Y..W.L...W.OW
WW.W.W.WL.WWWWW.LW.W.W.WW
W....W..WL.LWL.LW..W....W
W.WWWWW.WWWLWLWWW.WWWWW.W
WE..........K..........EW
WWWWWWWWWWWWWWWWWWWWWWWWW
