WWWWWWWWWWWWDWWWWWWWWWWWW
WL................2....LW
W.WWWWWWW.WWWWW.WWWWWWW.W
W.W.....WLLLWLL.W.....W.W
W...WWWCWLWLLLW.WHWWW...W
W.W.....WLWWLWW.W.....W.W
W2WWWWWWWLWLLLW.WWWWWWW.W
W.....PLLL..W...........W
W.WW.WWWWWWWWWWWWWWW.WW.W
WS.W...L.L..Y..W.L...W.OW
WW.W.W.WL.WWWWW.LW.W.W.WW
W....W..WL.LWL.LW..W....W
W.WWWWW.WWWLWLWWW.WWWWW.W
WL2.........K.......2..LW
WWWWWWWWWWWWWWWWWWWWWWWWW
1
false
3
8
0
0
0
0
1
