WWWWWWWWWWWWDWWWWWWWWWWWW
WL....................2LW
W.WWWWWWW.WWWWW.WWWWWWW.W
W.W.....WLLLWLL.W.....W.W
W2..WWWCWLWLLLW.WHWWW...W
W.W.....WLWWLWW.W.....W.W
W.WWWWWWWLWLLLW.WWWWWWW.W
WLLLPLLLLL..W...........W
W.WW.WWWWWWWWWWWWWWW.WW.W
WS.W...L.L..Y..W.L...W.OW
WW.W.W.WL.WWWWW.LW.W.W.WW
W....W..WL.LWL.LW..W..2.W
W.WWWWW.WWWLWLWWW.WWWWW.W
WL....2.....K..........LW
WWWWWWWWWWWWWWWWWWWWWWWWW
1
false
3
13
0
0
0
0
1
12:4
1:1
23:1
1:13
23:13
