WWWWWWWWWWWWWWWWWWWWWWWWW
WLL.LL.LL.LLELLLLLLLLLPLW
W.WWWWWWWWWWLWWWWWWWWWW.W
WKWL........L........LW.W
W.W.WWWWWW.WLW.WWWWWW.W.W
WOW........WLW........W.W
WWW.WWWWWWWWLWWWWWWWW.W.W
W...EL.LL.LLLLL.LL.LL...W
W.W.WWWWWWWWLWWWWWWWW.WWW
W.W........W.W........W.D
W.W.WWWWWW.WLW.WWWWWW.WLW
W.WL..2.........2....LWLW
W.WWWWWWWWWW.WWWWWWWWWW.W
WS...........LL.LL.LL.LLW
WWWWWWWWWWWWWWWWWWWWWWWWW
2
false
2
60
0
28
0
0
1
12:7
3:3
21:3
3:11
21:11
