WWWWWWWWWWWWDWWWWWWWWWWWW
WL.....................EW
W.WWWWWWW.WWWWW.WWWWWWW.W
W.W.....WLLLWLL.W.....W.W
W...WWWCWLWLLLW.WHWWW...W
W2W.....WLWWLWW.W.....W.W
W.WWWWWWWLWLLLW.WWWWWWW.W
W.....PLLL..W...........W
W.WW.WWWWWWWWWWWWWWW.WW.W
WS.W...L.L..Y..W.L...W.OW
WW.W.W.WL.WWWWW.LW.W.W.WW
W....W..WL.LWL.LW..W.2..W
W.WWWWW.WWWLWLWWW.WWWWW.W
WL...2......K..........LW
WWWWWWWWWWWWWWWWWWWWWWWWW
1
false
3
8
0
0
0
0
1
