WWWWWWWWWWWWWWWWWWWWWWWWW
WLL.LL.LL.LL...........CW
W.WWWWWWWWWW.WWWWWWWWWW.W
WKWE.................EW.W
W.W.WWWWWW.WLW.WWWWWW.W.W
WOW........W.W........W.W
WWW.WWWWWWWWLWWWWWWWW.W.W
W...LL.LL.LLPLL.LL.LL...W
W.W.WWWWWWWWLWWWWWWWW.WWW
W.W........W.W........W.D
W.W.WWWWWW.WLW.WWWWWW.WLW
W.WE.................EWLW
W.WWWWWWWWWW.WWWWWWWWWW.W
WS...........LL.LL.LL.LLW
WWWWWWWWWWWWWWWWWWWWWWWWW